1111111111111111
1111000000C11111
1111011111011111
1P0001E00P011111
1111111111111111
