111111111
10E000001
1CP011001
111111111
